Index,Arrival Time,Job Size,End Time,Start Job,Response Time,Turnaround Time,Job State,Context Switches
0,95,251,696,695,0,601,2,5
1,201,225,1369,1344,44,1168,2,4
2,267,251,2681,2680,78,2414,2,5
3,380,253,3934,3931,115,3554,2,5
4,452,254,4685,4681,193,4233,2,5
5,526,250,3581,3531,170,3055,2,4
6,617,247,4231,4184,229,3614,2,4
7,711,254,7971,7967,285,7260,2,5
8,773,248,5683,5635,323,4910,2,4
9,873,48,1294,1246,373,421,2,0
10,923,0,1344,1344,421,421,2,0
11,983,263,10586,10573,386,9603,2,5
12,1017,260,11526,11516,452,10509,2,5
13,1071,44,1613,1569,498,542,2,0
14,1121,29,1692,1663,542,571,2,0
15,1191,43,1785,1742,551,594,2,0
16,1315,45,1930,1885,570,615,2,0
17,1373,245,10271,10226,607,8898,2,4
18,1455,260,17106,17096,625,15651,2,5
19,1524,264,18688,18674,706,17164,2,5
20,1585,248,12581,12533,745,10996,2,4
21,1686,251,20725,20724,744,19039,2,5
22,1743,255,21813,21808,787,20070,2,5
23,1812,256,22519,22513,768,20707,2,5
24,1886,268,23462,23444,795,21576,2,5
25,1951,242,15429,15387,780,13478,2,4
26,2031,209,16248,16239,850,14217,2,4
27,2103,251,25977,25976,878,23874,2,5
28,2190,251,27325,27324,941,25135,2,5
29,2261,259,28367,28358,970,26106,2,5
30,2321,269,29628,29609,1010,27307,2,5
31,2402,249,20137,20088,1079,17735,2,4
32,2489,266,32684,32668,1142,30195,2,5
33,2545,227,21458,21431,1186,18913,2,4
34,2630,252,34546,34544,1201,31916,2,5
35,2687,225,23144,23119,1247,20457,2,4
36,2753,240,23802,23762,1281,21049,2,4
37,2818,53,6336,6333,1316,3518,2,1
38,2877,237,24536,24499,1354,21659,2,4
39,2934,254,39621,39617,1447,36687,2,5
40,3018,240,25926,25886,1463,22908,2,4
41,3067,230,26557,26527,1514,23490,2,4
42,3149,217,26924,26907,1536,23775,2,4
43,3221,265,42687,42672,1564,39466,2,5
44,3307,270,44298,44278,1628,40991,2,5
45,3380,285,45434,45399,1655,42054,2,5
46,3417,251,46332,46331,1718,42915,2,5
47,3490,243,30771,30728,1795,27281,2,4
48,3547,237,31480,31443,1838,27933,2,4
49,3610,226,31892,31866,1825,28282,2,4
50,3676,228,32370,32342,1859,28694,2,4
51,3741,55,8726,8721,1942,4985,2,1
52,3792,252,51963,51961,1991,48171,2,5
53,3876,254,52913,52909,2007,49037,2,5
54,3967,262,54779,54767,2066,50812,2,5
55,4016,233,36326,36293,2117,32310,2,4
56,4100,0,6283,6283,2183,2183,2,0
57,4186,245,37616,37571,2150,33430,2,4
58,4251,250,37716,37666,2135,33465,2,4
59,4310,246,38509,38463,2176,34199,2,4
60,4377,274,60188,60164,2209,55811,2,5
61,4459,52,10523,10521,2277,6064,2,1
62,4556,0,6886,6886,2330,2330,2,0
63,4614,251,62644,62643,2322,58030,2,5
64,4695,247,41858,41811,2391,37163,2,4
65,4760,253,64588,64585,2426,59828,2,5
66,4855,264,65837,65823,2481,60982,2,5
67,4926,247,43734,43687,2510,38808,2,4
68,4994,252,68683,68681,2592,63689,2,5
69,5056,254,69116,69112,2630,64060,2,5
70,5127,31,7817,7786,2659,2690,2,0
71,5187,265,71655,71640,2730,66468,2,5
72,5272,57,12433,12426,2699,7161,2,1
73,5339,225,48233,48208,2782,42894,2,4
74,5437,265,74897,74882,2834,69460,2,5
75,5506,233,49633,49600,2865,44127,2,4
76,5549,63,13281,13268,2922,7732,2,1
77,5638,56,13537,13531,2983,7899,2,1
78,5700,263,77770,77757,2971,72070,2,5
79,5754,259,78628,78619,2972,72874,2,5
80,5830,251,79129,79128,2996,73299,2,5
81,5893,255,80243,80238,3083,74350,2,5
82,5962,258,81320,81312,3114,75358,2,5
83,5994,258,82427,82419,3182,76433,2,5
84,6043,247,54463,54416,3233,48420,2,4
85,6113,277,84597,84570,3263,78484,2,5
86,6175,53,14937,14934,3301,8762,2,1
87,6243,256,86567,86561,3383,80324,2,5
88,6271,243,57003,56960,3405,50732,2,4
89,6340,60,15489,15479,3486,9149,2,1
90,6441,264,89467,89453,3535,83026,2,5
91,6512,256,90689,90683,3564,84177,2,5
92,6575,252,91671,91669,3601,85096,2,5
93,6645,244,60432,60388,3676,53787,2,4
94,6724,236,60968,60932,3697,54244,2,4
95,6792,213,61370,61357,3731,54578,2,4
96,6853,234,61750,61716,3733,54897,2,4
97,6938,239,62393,62354,3798,55455,2,4
98,7014,241,63135,63094,3822,56121,2,4
99,7110,256,97959,97953,3876,90849,2,5
100,7209,30,11166,11136,3927,3957,2,0
101,7279,253,99503,99500,3937,92224,2,5
102,7335,253,99886,99883,3981,92551,2,5
103,7395,265,100940,100925,4071,93545,2,5
104,7452,259,101769,101760,4074,94317,2,5
105,7532,68,18224,18206,4094,10692,2,1
106,7574,267,103045,103028,4152,95471,2,5
107,7633,251,104299,104298,4193,96666,2,5
108,7735,269,105148,105129,4241,97413,2,5
109,7812,275,106799,106774,4314,98987,2,5
110,7872,262,107661,107649,4354,99789,2,5
111,7951,264,108706,108692,4375,100755,2,5
112,8028,233,71888,71855,4405,63860,2,4
113,8061,260,110389,110379,4422,102328,2,5
114,8128,231,73300,73269,4503,65172,2,4
115,8215,247,73946,73899,4516,65731,2,4
116,8289,40,12921,12881,4592,4632,2,0
117,8337,238,75385,75347,4634,67048,2,4
118,8387,47,13118,13071,4684,4731,2,0
119,8447,263,116262,116249,4721,107815,2,5
120,8524,55,20780,20775,4757,12256,2,1
121,8587,254,117374,117370,4794,108787,2,5
122,8652,221,77607,77586,4829,68955,2,4
123,8742,249,78069,78020,4845,69327,2,4
124,8798,51,21381,21380,4889,12583,2,1
125,8890,254,121255,121251,4947,112365,2,5
126,8965,255,121734,121729,4972,112769,2,5
127,9052,50,14137,14087,5035,5085,2,0
128,9074,47,14184,14137,5063,5110,2,0
129,9127,244,81564,81520,5157,72437,2,4
130,9213,205,82119,82114,5171,72906,2,4
131,9297,253,126487,126484,5237,117190,2,5
132,9360,221,83738,83717,5274,74378,2,4
133,9417,262,128215,128203,5317,118798,2,5
134,9475,229,84626,84597,5359,75151,2,4
135,9558,239,85415,85376,5379,75857,2,4
136,9622,246,86311,86265,5415,76689,2,4
137,9708,263,132246,132233,5479,122538,2,5
138,9807,259,133178,133169,5530,123371,2,5
139,9865,289,134067,134028,5564,124202,2,5
140,9985,260,135865,135855,5604,125880,2,5
141,10064,272,136365,136343,5625,126301,2,5
142,10120,240,90252,90212,5669,80132,2,4
143,10183,243,91232,91189,5756,81049,2,4
144,10287,247,91968,91921,5752,81681,2,4
145,10363,247,92244,92197,5776,81881,2,4
146,10440,223,92799,92776,5808,82359,2,4
147,10526,232,93681,93649,5872,83155,2,4
148,10574,241,94072,94031,5924,83498,2,4
149,10664,0,16598,16598,5934,5934,2,0
150,10697,48,16696,16648,5951,5999,2,0
151,10768,245,94864,94819,5978,84096,2,4
152,10840,250,96114,96064,6056,85274,2,4
153,10931,246,97116,97070,6065,86185,2,4
154,11000,234,97500,97466,6106,86500,2,4
155,11063,264,148700,148686,6143,137637,2,5
156,11140,251,149722,149721,6216,138582,2,5
157,11250,255,150127,150122,6206,138877,2,5
158,11264,248,99150,99102,6242,87886,2,4
159,11351,235,99836,99801,6305,88485,2,4
160,11423,239,100625,100586,6383,89202,2,4
161,11519,226,101310,101284,6437,89791,2,4
162,11605,242,101861,101819,6451,90256,2,4
163,11597,228,102389,102361,6509,90792,2,4
164,11681,239,102878,102839,6543,91197,2,4
165,11777,268,156489,156471,6597,144712,2,5
166,11836,247,104048,104001,6638,92212,2,4
167,11920,259,158272,158263,6654,146352,2,5
168,11998,236,104979,104943,6690,92981,2,4
169,12098,238,105781,105743,6740,93683,2,4
170,12167,252,160991,160989,6771,148824,2,5
171,12239,252,162275,162273,6849,150036,2,5
172,12281,245,108006,107961,6907,95725,2,4
173,12327,265,164113,164098,6961,151786,2,5
174,12404,233,108989,108956,6984,96585,2,4
175,12505,258,166144,166136,7033,153639,2,5
176,12571,259,167538,167529,7067,154967,2,5
177,12641,240,111431,111391,7097,98790,2,4
178,12696,295,169279,169234,7142,156583,2,5
179,12762,73,31144,31121,7176,18382,2,1
180,12829,220,113231,113211,7209,100402,2,4
181,12896,244,113575,113531,7291,100679,2,4
182,12966,243,114018,113975,7271,101052,2,4
183,13007,248,114760,114712,7330,101753,2,4
184,13075,248,115438,115390,7412,102363,2,4
185,13139,229,115665,115636,7398,102526,2,4
186,13191,37,20674,20637,7446,7483,2,0
187,13273,238,116749,116711,7452,103476,2,4
188,13391,234,117270,117236,7439,103879,2,4
189,13466,236,117810,117774,7464,104344,2,4
190,13521,238,118148,118110,7509,104627,2,4
191,13610,257,174831,174824,7570,161221,2,5
192,13675,258,175305,175297,7605,161630,2,5
193,13774,62,33295,33283,7607,19521,2,1
194,13833,258,176165,176157,7625,162332,2,5
195,13959,224,121579,121555,7699,107620,2,4
196,14032,269,177587,177568,7726,163555,2,5
197,14111,233,122824,122791,7752,108713,2,4
198,14211,234,123149,123115,7702,108938,2,4
199,14279,249,123655,123606,7734,109376,2,4
200,14340,249,124352,124303,7823,110012,2,4
201,14414,232,124793,124761,7849,110379,2,4
202,14474,249,125192,125143,7889,110718,2,4
203,14509,242,125984,125942,7954,111475,2,4
204,14585,246,126733,126687,7984,112148,2,4
205,14665,270,181616,181596,8004,166951,2,5
206,14738,287,182356,182319,8081,167618,2,5
207,14797,246,128461,128415,8122,113664,2,4
208,14898,234,129501,129467,8171,114603,2,4
209,14961,227,129922,129895,8183,114961,2,4
210,15015,263,184585,184572,8229,169570,2,5
211,15072,215,131137,131122,8272,116065,2,4
212,15167,242,131879,131837,8295,116712,2,4
213,15246,248,132644,132596,8366,117398,2,4
214,15302,229,132872,132843,8410,117570,2,4
215,15392,262,187223,187211,8460,171831,2,5
216,15446,256,187379,187373,8456,171933,2,5
217,15493,225,134532,134507,8509,119039,2,4
218,15538,256,188102,188096,8514,172564,2,5
219,15599,266,188818,188802,8603,173219,2,5
220,15651,47,24349,24302,8651,8698,2,0
221,15720,241,136193,136152,8679,120473,2,4
222,15817,233,136906,136873,8719,121089,2,4
223,15871,247,137246,137199,8765,121375,2,4
224,15947,231,138370,138339,8839,122423,2,4
225,16015,234,138703,138669,8871,122688,2,4
226,16081,260,192094,192084,8905,176013,2,5
227,16176,55,39139,39134,8960,22963,2,1
228,16262,248,140315,140267,9024,124053,2,4
229,16343,254,193412,193408,9043,177069,2,5
230,16420,276,194081,194055,9116,177661,2,5
231,16501,281,194667,194636,9185,178166,2,5
232,16591,250,143023,142973,9195,126432,2,4
233,16682,240,143450,143410,9244,126768,2,4
234,16800,56,40520,40514,9227,23720,2,1
235,16853,271,196692,196671,9274,179839,2,5
236,16918,274,197129,197105,9309,180211,2,5
237,16983,255,198099,198094,9344,181116,2,5
238,17046,221,146915,146894,9381,129869,2,4
239,17135,256,199480,199474,9422,182345,2,5
240,17193,249,148378,148329,9464,131185,2,4
241,17276,238,149075,149037,9531,131799,2,4
242,17377,51,41909,41908,9547,24532,2,1
243,17479,63,42072,42059,9595,24593,2,1
244,17595,257,201861,201854,9629,184266,2,5
245,17684,44,27369,27325,9641,9685,2,0
246,17759,269,202790,202771,9710,185031,2,5
247,17822,43,27612,27569,9747,9790,2,0
248,17918,234,152822,152788,9794,134904,2,4
249,17974,258,203945,203937,9838,185971,2,5
250,18037,256,204383,204377,9875,186346,2,5
251,18140,273,205342,205319,9922,187202,2,5
252,18214,266,205977,205961,9998,187763,2,5
253,18315,46,28358,28312,9997,10043,2,0
254,18400,273,206800,206777,10017,188400,2,5
255,18458,245,156979,156934,10059,138521,2,4
256,18509,249,157378,157329,10108,138869,2,4
257,18563,42,28759,28717,10154,10196,2,0
258,18647,259,208471,208462,10212,189824,2,5
259,18724,248,158774,158726,10235,140050,2,4
260,18814,266,209187,209171,10295,190373,2,5
261,18864,57,45299,45292,10345,26435,2,1
262,18947,248,160717,160669,10412,141770,2,4
263,19006,253,210780,210777,10453,191774,2,5
264,19071,246,161823,161777,10488,142752,2,4
265,19145,226,162601,162575,10533,143456,2,4
266,19225,277,212603,212576,10553,193378,2,5
267,19317,253,213362,213359,10611,194045,2,5
268,19423,242,164409,164367,10655,144986,2,4
269,19478,258,214360,214352,10700,194882,2,5
270,19533,273,214842,214819,10745,195309,2,5
271,19599,246,166590,166544,10829,146991,2,4
272,19637,259,215745,215736,10841,196108,2,5
273,19716,256,216644,216638,10912,196928,2,5
274,19728,279,216673,216644,10950,196945,2,5
275,19792,256,217310,217304,11029,197518,2,5
276,19858,246,169028,168982,11063,149170,2,4
277,19916,241,169320,169279,11105,149404,2,4
278,20004,228,169748,169720,11140,149744,2,4
279,20040,252,218307,218305,11204,198267,2,5
280,20118,260,218609,218599,11226,198491,2,5
281,20174,49,31443,31394,11220,11269,2,0
282,20257,215,170766,170751,11273,150509,2,4
283,20349,242,171061,171019,11331,150712,2,4
284,20445,36,31866,31830,11385,11421,2,0
285,20495,67,49300,49283,11397,28805,2,1
286,20557,245,171959,171914,11435,151402,2,4
287,20655,247,172456,172409,11487,151801,2,4
288,20732,233,172789,172756,11510,152057,2,4
289,20831,240,173179,173139,11539,152348,2,4
290,20867,50,32470,32420,11553,11603,2,0
291,20976,48,32618,32570,11594,11642,2,0
292,21050,49,32733,32684,11634,11683,2,0
293,21105,240,174288,174248,11678,153183,2,4
294,21227,232,174774,174742,11706,153547,2,4
295,21318,253,222848,222845,11765,201530,2,5
296,21374,254,223202,223198,11809,201828,2,5
297,21473,233,176005,175972,11822,154532,2,4
298,21576,254,224064,224060,11869,202488,2,5
299,21646,250,176765,176715,11899,155119,2,4
300,21729,278,224592,224564,11966,202863,2,5
301,21777,251,224743,224742,12018,202966,2,5
302,21840,242,177879,177837,12055,156039,2,4
303,21945,241,178220,178179,12100,156275,2,4
304,21988,246,178516,178470,12157,156528,2,4
305,22078,225,178791,178766,12217,156713,2,4
306,22150,49,34444,34395,12245,12294,2,0
307,22286,230,179493,179463,12260,157207,2,4
308,22344,271,226787,226766,12302,204443,2,5
309,22416,240,180138,180098,12380,157722,2,4
310,22478,252,227411,227409,12418,204933,2,5
311,22541,253,227764,227761,12455,205223,2,5
312,22613,53,54266,54263,12483,31653,2,1
313,22689,47,35293,35246,12557,12604,2,0
314,22739,244,182010,181966,12604,159271,2,4
315,22812,54,54767,54763,12631,31955,2,1
316,22884,249,182464,182415,12709,159580,2,4
317,22961,254,229190,229186,12732,206229,2,5
318,23009,272,229562,229540,12784,206553,2,5
319,23088,253,229915,229912,12855,206827,2,5
320,23157,258,230273,230265,12886,207116,2,5
321,23266,261,230682,230671,12927,207416,2,5
322,23352,266,231098,231082,12974,207746,2,5
323,23404,265,231620,231605,13022,208216,2,5
324,23470,48,36574,36526,13056,13104,2,0
325,23588,249,185984,185935,13086,162396,2,4
326,23651,247,186288,186241,13123,162637,2,4
327,23729,0,36924,36924,13195,13195,2,0
328,23795,223,186661,186638,13179,162866,2,4
329,23861,267,233112,233095,13213,209251,2,5
330,23920,47,37221,37174,13254,13301,2,0
331,23977,246,187525,187479,13294,163548,2,4
332,24045,221,187796,187775,13326,163751,2,4
333,24127,266,234249,234233,13394,210122,2,5
334,24185,259,234408,234399,13431,210223,2,5
335,24284,251,234797,234796,13482,210513,2,5
336,24344,47,37913,37866,13522,13569,2,0
337,24445,240,189308,189268,13518,164863,2,4
338,24515,245,189753,189708,13598,165238,2,4
339,24613,52,58990,58988,13600,34377,2,1
340,24699,242,190495,190453,13664,165796,2,4
341,24795,238,191033,190995,13714,166238,2,4
342,24874,245,191340,191295,13735,166466,2,4
343,24937,244,191734,191690,13822,166797,2,4
344,24991,50,38909,38859,13868,13918,2,0
345,25086,25,38984,38959,13873,13898,2,0
346,25155,258,237847,237839,13929,212692,2,5
347,25248,46,39235,39189,13941,13987,2,0
348,25315,32,39317,39285,13970,14002,2,0
349,25373,270,238444,238424,13994,213071,2,5
350,25465,243,193706,193663,14052,168241,2,4
351,25542,244,193900,193856,14079,168358,2,4
352,25633,256,239589,239583,14088,213956,2,5
353,25711,50,39921,39871,14160,14210,2,0
354,25768,43,40014,39971,14203,14246,2,0
355,25833,241,195058,195017,14231,169225,2,4
356,25912,240,195298,195258,14302,169386,2,4
357,25947,251,240351,240350,14317,214404,2,5
358,25984,54,62054,62050,14380,36070,2,1
359,26061,250,196048,195998,14403,169987,2,4
360,26087,250,196298,196248,14433,170211,2,4
361,26161,41,40661,40620,14459,14500,2,0
362,26204,257,241586,241579,14507,215382,2,5
363,26293,238,197417,197379,14568,171124,2,4
364,26375,227,197894,197867,14586,171519,2,4
365,26440,240,198389,198349,14671,171949,2,4
366,26504,244,198833,198789,14707,172329,2,4
367,26589,241,199174,199133,14722,172585,2,4
368,26671,248,199878,199830,14790,173207,2,4
369,26746,253,244360,244357,14815,217614,2,5
370,26830,239,200367,200328,14881,173537,2,4
371,26934,224,200641,200617,14924,173707,2,4
372,27023,221,200862,200841,14886,173839,2,4
373,27133,277,245446,245419,14939,218313,2,5
374,27240,241,201754,201713,14982,174514,2,4
375,27331,264,246160,246146,15041,218829,2,5
376,27419,232,202293,202261,15003,174874,2,4
377,27475,228,202621,202593,15097,175146,2,4
378,27576,252,246862,246860,15111,219286,2,5
379,27659,240,203230,203190,15078,175571,2,4
380,27753,243,203637,203594,15134,175884,2,4
381,27846,63,66150,66137,15191,38304,2,1
382,27919,229,204224,204195,15268,176305,2,4
383,27986,262,248344,248332,15301,220358,2,5
384,28078,236,205019,204983,15359,176941,2,4
385,28095,249,205269,205220,15392,177174,2,4
386,28168,255,249288,249283,15469,221120,2,5
387,28271,46,43830,43784,15513,15559,2,0
388,28343,242,206270,206228,15537,177927,2,4
389,28424,247,206477,206430,15556,178053,2,4
390,28444,48,44078,44030,15586,15634,2,0
391,28523,251,250362,250361,15655,221839,2,5
392,28620,261,250673,250662,15678,222053,2,5
393,28669,55,68131,68126,15729,39462,2,1
394,28719,248,207862,207814,15779,179143,2,4
395,28821,259,251265,251256,15777,222444,2,5
396,28910,44,44792,44748,15838,15882,2,0
397,28975,55,68688,68683,15867,39713,2,1
398,29071,57,68878,68871,15921,39807,2,1
399,29177,275,252509,252484,15965,223332,2,5
400,29242,259,252718,252709,16000,223476,2,5
401,29332,247,210084,210037,16017,180752,2,4
402,29383,243,210427,210384,16051,181044,2,4
403,29483,47,45631,45584,16101,16148,2,0
404,29532,62,69828,69816,16149,40296,2,1
405,29592,250,211180,211130,16189,181588,2,4
406,29659,223,211653,211630,16222,181994,2,4
407,29728,264,254652,254638,16253,224924,2,5
408,29804,223,212376,212353,16327,182572,2,4
409,29884,251,255650,255649,16397,225766,2,5
410,29974,247,213209,213162,16358,183235,2,4
411,30050,268,256118,256100,16432,226068,2,5
412,30143,231,213954,213923,16489,183811,2,4
413,30227,248,214302,214254,16505,184075,2,4
414,30315,259,257116,257107,16567,226801,2,5
415,30381,31,47063,47032,16651,16682,2,0
416,30452,239,215286,215247,16661,184834,2,4
417,30496,254,257894,257890,16717,227398,2,5
418,30595,243,216038,215995,16768,185443,2,4
419,30665,267,258508,258491,16798,227843,2,5
420,30740,236,216909,216873,16873,186169,2,4
421,30812,245,217104,217059,16851,186292,2,4
422,30885,245,217455,217410,16928,186570,2,4
423,30984,261,259569,259558,16979,228585,2,5
424,31043,45,48108,48063,17020,17065,2,0
425,31114,265,259784,259769,17044,228670,2,5
426,31189,251,259885,259884,17044,228696,2,5
427,31255,259,260024,260015,17128,228769,2,5
428,31326,242,218499,218457,17157,187173,2,4
429,31400,0,48633,48633,17233,17233,2,0
430,31484,253,260407,260404,17149,228923,2,5
431,31539,255,260512,260507,17194,228973,2,5
432,31665,240,219149,219109,17218,187484,2,4
433,31739,260,260848,260838,17294,229109,2,5
434,31828,276,261074,261048,17305,229246,2,5
435,31900,238,219787,219749,17333,187887,2,4
436,31975,246,219933,219887,17325,187958,2,4
437,32018,0,49400,49400,17382,17382,2,0
438,32047,54,75739,75735,17403,43692,2,1
439,32111,217,220250,220233,17439,188139,2,4
440,32182,266,261731,261715,17451,229549,2,5
441,32267,281,262012,261981,17516,229745,2,5
442,32331,227,220877,220850,17552,188546,2,4
443,32407,254,262223,262219,17576,229816,2,5
444,32499,263,262363,262350,17584,229864,2,5
445,32549,40,50223,50183,17634,17674,2,0
446,32574,247,221624,221577,17699,189050,2,4
447,32652,241,221665,221624,17671,189013,2,4
448,32715,264,262922,262908,17708,230207,2,5
449,32798,253,263057,263054,17725,230259,2,5
450,32890,260,263226,263216,17783,230336,2,5
451,32965,47,50820,50773,17808,17855,2,0
452,33044,41,50961,50920,17876,17917,2,0
453,33101,230,222795,222765,17910,189694,2,4
454,33167,269,263775,263756,17944,230608,2,5
455,33251,259,264077,264068,18010,230826,2,5
456,33284,248,223450,223402,18077,190166,2,4
457,33335,232,223582,223550,18076,190247,2,4
458,33378,235,223767,223732,18133,190389,2,4
459,33439,243,223960,223917,18172,190521,2,4
460,33539,275,264644,264619,18222,231105,2,5
461,33620,60,79489,79479,18291,45869,2,1
462,33706,47,52060,52013,18307,18354,2,0
463,33777,49,52159,52110,18333,18382,2,0
464,33847,242,224885,224843,18412,191038,2,4
465,33935,261,265490,265479,18424,231555,2,5
466,34001,250,225385,225335,18508,191384,2,4
467,34040,227,225412,225385,18519,191372,2,4
468,34102,217,225579,225562,18607,191477,2,4
469,34170,220,225649,225629,18639,191479,2,4
470,34263,235,225784,225749,18650,191521,2,4
471,34291,226,225810,225784,18672,191519,2,4
472,34357,281,266193,266162,18756,231836,2,5
473,34414,245,226155,226110,18799,191741,2,4
474,34475,253,266296,266293,18788,231821,2,5
475,34561,232,226487,226455,18852,191926,2,4
476,34620,229,226616,226587,18893,191996,2,4
477,34738,0,53663,53663,18925,18925,2,0
478,34837,235,226972,226937,18926,192135,2,4
479,34921,237,227259,227222,18992,192338,2,4
480,35017,262,267440,267428,19046,232423,2,5
481,35082,263,267588,267575,19081,232506,2,5
482,35148,264,267741,267727,19118,232593,2,5
483,35222,237,228201,228164,19144,192979,2,4
484,35299,267,267958,267941,19164,232659,2,5
485,35366,272,268135,268113,19197,232769,2,5
486,35424,253,268270,268267,19239,232846,2,5
487,35552,235,228986,228951,19227,193434,2,4
488,35640,271,268478,268457,19239,232838,2,5
489,35705,267,268495,268478,19324,232790,2,5
490,35797,252,268747,268745,19382,232950,2,5
491,35864,50,55329,55279,19415,19465,2,0
492,35960,254,269032,269028,19469,233072,2,5
493,36015,257,269132,269125,19514,233117,2,5
494,36078,253,269285,269282,19551,233207,2,5
495,36170,248,230421,230373,19609,194251,2,4
496,36220,31,55910,55879,19659,19690,2,0
497,36285,256,269890,269884,19675,233605,2,5
498,36379,261,270116,270105,19731,233737,2,5
499,36403,207,231305,231298,19757,194902,2,4
500,36459,261,270366,270355,19801,233907,2,5
501,36543,294,270597,270553,19867,234054,2,5
502,36602,275,270772,270747,19858,234170,2,5
503,36681,53,86620,86617,19929,49939,2,1
504,36762,245,232315,232270,19948,195553,2,4
505,36849,236,232551,232515,20011,195702,2,4
506,36942,244,232745,232701,20061,195803,2,4
507,37036,43,57196,57153,20117,20160,2,0
508,37061,261,271466,271455,20135,234405,2,5
509,37155,267,271633,271616,20191,234478,2,5
510,37260,234,233346,233312,20186,196086,2,4
511,37375,269,272102,272083,20271,234727,2,5
512,37444,237,233933,233896,20302,196489,2,4
513,37522,257,272538,272531,20374,235016,2,5
514,37614,269,272657,272638,20382,235043,2,5
515,37680,240,234498,234458,20416,196818,2,4
516,37736,269,272826,272807,20410,235090,2,5
517,37790,248,234796,234748,20456,197006,2,4
518,37890,61,89403,89392,20506,51513,2,1
519,37993,67,89484,89467,20503,51491,2,1
520,38068,262,273286,273274,20578,235218,2,5
521,38125,220,235367,235347,20621,197242,2,4
522,38189,229,235596,235567,20657,197407,2,4
523,38245,42,58988,58946,20701,20743,2,0
524,38316,246,235842,235796,20724,197526,2,4
525,38367,238,236030,235992,20773,197663,2,4
526,38417,263,274065,274052,20823,235648,2,5
527,38485,259,274324,274315,20855,235839,2,5
528,38575,252,274526,274524,20865,235951,2,5
529,38666,48,59638,59590,20924,20972,2,0
530,38760,228,237108,237080,20978,198348,2,4
531,38823,264,274915,274901,21015,236092,2,5
532,38903,231,237439,237408,21035,198536,2,4
533,38989,258,275211,275203,21049,236222,2,5
534,39051,26,60164,60138,21087,21113,2,0
535,39135,227,237874,237847,21103,198739,2,4
536,39205,266,275615,275599,21133,236410,2,5
537,39319,51,92381,92380,21113,53062,2,1
538,39375,257,275772,275765,21157,236397,2,5
539,39425,262,275924,275912,21207,236499,2,5
540,39477,253,276069,276066,21255,236592,2,5
541,39537,253,276187,276184,21295,236650,2,5
542,39626,39,61007,60968,21342,21381,2,0
543,39678,241,239235,239194,21379,199557,2,4
544,39730,248,239433,239385,21427,199703,2,4
545,39844,228,239617,239589,21463,199773,2,4
546,39984,46,61466,61420,21436,21482,2,0
547,40063,243,239860,239817,21403,199797,2,4
548,40141,240,240150,240110,21475,200009,2,4
549,40238,52,94369,94367,21512,54131,2,1
550,40328,230,240431,240401,21572,200103,2,4
551,40408,256,277562,277556,21592,237154,2,5
552,40481,251,277706,277705,21623,237225,2,5
553,40551,274,277980,277956,21653,237429,2,5
554,40611,223,241254,241231,21693,200643,2,4
555,40646,258,278188,278180,21747,237542,2,5
556,40727,225,241579,241554,21766,200852,2,4
557,40800,256,278487,278481,21793,237687,2,5
558,40863,243,241929,241886,21831,201066,2,4
559,40932,267,278693,278676,21862,237761,2,5
560,40962,241,242370,242329,21932,201408,2,4
561,41046,58,96372,96364,21948,55326,2,1
562,41138,252,279216,279214,21997,238078,2,5
563,41201,222,242992,242970,22034,201791,2,4
564,41258,243,243235,243192,22077,201977,2,4
565,41346,226,243561,243535,22139,202215,2,4
566,41401,246,243807,243761,22184,202406,2,4
567,41477,275,280340,280315,22258,238863,2,5
568,41566,62,97812,97800,22319,56246,2,1
569,41653,50,64035,63985,22332,22382,2,0
570,41740,241,244551,244510,22395,202811,2,4
571,41794,254,280784,280780,22441,238990,2,5
572,41922,218,244969,244951,22463,203047,2,4
573,41960,262,281236,281224,22525,239276,2,5
574,42072,260,281333,281323,22516,239261,2,5
575,42165,35,64723,64688,22523,22558,2,0
576,42236,259,281786,281777,22587,239550,2,5
577,42332,259,281883,281874,22641,239551,2,5
578,42439,52,99651,99649,22684,57212,2,1
579,42521,265,282287,282272,22702,239766,2,5
580,42623,274,282511,282487,22800,239888,2,5
581,42697,253,282614,282611,22826,239917,2,5
582,42767,250,247012,246962,22856,204245,2,4
583,42835,259,282804,282795,22888,239969,2,5
584,42927,245,247407,247362,22910,204480,2,4
585,43048,262,283216,283204,22989,240168,2,5
586,43076,265,283231,283216,23011,240155,2,5
587,43164,245,247852,247807,23036,204688,2,4
588,43253,230,248032,248002,23097,204779,2,4
589,43312,260,283672,283662,23138,240360,2,5
590,43390,41,66641,66600,23210,23251,2,0
591,43445,249,248693,248644,23246,205248,2,4
592,43524,266,284119,284103,23267,240595,2,5
593,43634,250,249093,249043,23307,205459,2,4
594,43680,240,249183,249143,23361,205503,2,4
595,43756,246,249434,249388,23385,205678,2,4
596,43860,243,249577,249534,23381,205717,2,4
597,43951,240,249817,249777,23440,205866,2,4
598,44048,36,67577,67541,23493,23529,2,0
599,44105,244,250011,249967,23472,205906,2,4
600,44181,49,67776,67727,23546,23595,2,0
601,44260,53,103548,103545,23566,59288,2,1
602,44336,276,285559,285533,23590,241223,2,5
603,44409,233,250856,250823,23667,206447,2,4
604,44497,53,103951,103948,23634,59454,2,1
605,44569,257,285989,285982,23712,241420,2,5
606,44673,247,251462,251415,23758,206789,2,4
607,44749,279,286518,286489,23832,241769,2,5
608,44827,247,251809,251762,23804,206982,2,4
609,44939,33,68721,68688,23749,23782,2,0
610,45012,238,251997,251959,23809,206985,2,4
611,45078,34,68912,68878,23800,23834,2,0
612,45185,237,252384,252347,23827,207199,2,4
613,45264,252,287199,287197,23852,241935,2,5
614,45329,248,252816,252768,23887,207487,2,4
615,45391,274,287415,287391,23925,242024,2,5
616,45447,260,287560,287550,23969,242113,2,5
617,45480,252,287612,287610,23986,242132,2,5
618,45565,217,253533,253516,24051,207968,2,4
619,45687,236,253719,253683,24079,208032,2,4
620,45763,249,253868,253819,24065,208105,2,4
621,45837,247,254115,254068,24141,208278,2,4
622,45915,223,254388,254365,24163,208473,2,4
623,45981,28,70206,70178,24197,24225,2,0
624,46045,258,288825,288817,24261,242780,2,5
625,46124,252,288976,288974,24282,242852,2,5
626,46192,247,255199,255152,24364,209007,2,4
627,46236,46,70702,70656,24420,24466,2,0
628,46328,71,108077,108056,24424,61749,2,1
629,46368,253,289544,289541,24484,243176,2,5
630,46445,38,71040,71002,24557,24595,2,0
631,46565,65,108642,108627,24575,62077,2,1
632,46663,249,256367,256318,24627,209704,2,4
633,46750,248,256665,256617,24690,209915,2,4
634,46872,242,256957,256915,24718,210085,2,4
635,46945,238,257154,257116,24760,210209,2,4
636,47007,239,257293,257254,24798,210286,2,4
637,47073,247,257440,257393,24815,210367,2,4
638,47142,253,291008,291005,24846,243866,2,5
639,47233,255,291200,291195,24905,243967,2,5
640,47313,31,72269,72238,24925,24956,2,0
641,47377,64,110453,110439,24992,63076,2,1
642,47451,247,258341,258294,25018,210890,2,4
643,47530,253,291871,291868,25089,244341,2,5
644,47635,260,291990,291980,25134,244355,2,5
645,47739,255,292240,292235,25180,244501,2,5
646,47812,269,292359,292340,25207,244547,2,5
647,47861,251,292360,292359,25258,244499,2,5
648,47909,53,111834,111831,25310,63925,2,1
649,48015,55,112039,112034,25385,64024,2,1
650,48041,269,292511,292492,25409,244470,2,5
651,48163,49,73649,73600,25437,25486,2,0
652,48229,258,292715,292707,25470,244486,2,5
653,48288,230,259915,259885,25511,211627,2,4
654,48387,36,73982,73946,25559,25595,2,0
655,48446,252,292821,292819,25586,244375,2,5
656,48531,238,260212,260174,25601,211681,2,4
657,48622,200,218599,218549,25660,169977,2,3
658,48676,242,260404,260362,25706,211728,2,4
659,48745,260,293037,293027,25787,244292,2,5
660,48832,261,293064,293053,25800,244232,2,5
661,48912,227,260639,260612,25870,211727,2,4
662,49005,250,260739,260689,25892,211734,2,4
663,49059,249,260838,260789,25938,211779,2,4
664,49110,266,293218,293202,25987,244108,2,5
665,49136,252,293248,293246,26061,244112,2,5
666,49231,245,261169,261124,26066,211938,2,4
667,49294,246,261315,261269,26141,212021,2,4
668,49385,258,293438,293430,26150,244053,2,5
669,49471,268,293487,293469,26214,244016,2,5
670,49578,47,75836,75789,26211,26258,2,0
671,49650,267,293642,293625,26236,243992,2,5
672,49704,253,293645,293642,26282,243941,2,5
673,49759,256,293681,293675,26327,243922,2,5
674,49874,235,262047,262012,26362,212173,2,4
675,49932,237,262134,262097,26404,212202,2,4
676,49989,235,262219,262184,26497,212230,2,4
677,50049,227,262250,262223,26537,212201,2,4
678,50173,252,293944,293942,26563,243771,2,5
679,50252,251,293988,293987,26584,243736,2,5
680,50321,267,294105,294088,26615,243784,2,5
681,50388,245,262808,262763,26698,212420,2,4
682,50474,232,262954,262922,26762,212480,2,4
683,50513,252,294293,294291,26773,243780,2,5
684,50585,236,263093,263057,26851,212508,2,4
685,50647,224,263117,263093,26889,212470,2,4
686,50700,249,263216,263167,26907,212516,2,4
687,50764,244,263320,263276,26943,212556,2,4
688,50782,263,294471,294458,26988,243689,2,5
689,50871,256,294521,294515,26999,243650,2,5
690,50954,241,263561,263520,27016,212607,2,4
691,51046,252,294523,294521,27023,243477,2,5
692,51136,245,263756,263711,27083,212620,2,4
693,51247,247,263922,263875,27122,212675,2,4
694,51301,246,264068,264022,27168,212767,2,4
695,51360,279,294752,294723,27209,243392,2,5
696,51442,265,294809,294794,27236,243367,2,5
697,51536,281,294878,294847,27292,243342,2,5
698,51617,242,264419,264377,27361,212802,2,4
699,51650,258,294967,294959,27378,243317,2,5
700,51724,51,120951,120950,27405,69227,2,1
701,51848,244,264738,264694,27431,212890,2,4
702,51925,253,295188,295185,27504,243263,2,5
703,52011,243,264981,264938,27478,212970,2,4
704,52108,49,79638,79589,27481,27530,2,0
705,52230,213,265144,265131,27508,212914,2,4
706,52278,244,265288,265244,27560,213010,2,4
707,52323,241,265329,265288,27615,213006,2,4
708,52390,251,295459,295458,27648,243069,2,5
709,52459,238,265578,265540,27679,213119,2,4
710,52527,262,295571,295559,27716,243044,2,5
711,52611,57,122741,122734,27782,70130,2,1
712,52687,268,295681,295663,27806,242994,2,5
713,52748,42,80635,80593,27845,27887,2,0
714,52844,57,123156,123149,27891,70312,2,1
715,52924,234,265962,265928,27961,213038,2,4
716,53031,256,295850,295844,28004,242819,2,5
717,53126,256,295856,295850,28059,242730,2,5
718,53208,27,81312,81285,28077,28104,2,0
719,53285,257,295955,295948,28085,242670,2,5
720,53346,255,295993,295988,28124,242647,2,5
721,53404,266,296009,295993,28160,242605,2,5
722,53485,230,266526,266496,28229,213041,2,4
723,53544,59,124661,124652,28270,71117,2,1
724,53622,243,266719,266676,28342,213097,2,4
725,53666,250,266769,266719,28398,213103,2,4
726,53748,242,266811,266769,28371,213063,2,4
727,53821,240,266951,266911,28448,213130,2,4
728,53909,257,296349,296342,28460,242440,2,5
729,53965,257,296446,296439,28512,242481,2,5
730,54033,261,296507,296496,28544,242474,2,5
731,54087,227,267378,267351,28590,213291,2,4
732,54154,235,267475,267440,28623,213321,2,4
733,54294,239,267677,267638,28683,213383,2,4
734,54372,54,126737,126733,28755,72365,2,1
735,54462,40,83267,83227,28765,28805,2,0
736,54520,61,127048,127037,28797,72528,2,1
737,54611,205,268063,268058,28806,213452,2,4
738,54659,232,268217,268185,28858,213558,2,4
739,54739,246,268366,268320,28928,213627,2,4
740,54828,241,268407,268366,28910,213579,2,4
741,54931,57,128053,128046,29007,73122,2,1
742,55009,37,84075,84038,29029,29066,2,0
743,55098,45,84220,84175,29077,29122,2,0
744,55189,66,128527,128511,29131,73338,2,1
745,55277,243,268790,268747,29143,213513,2,4
746,55354,261,297539,297528,29166,242185,2,5
747,55453,238,268978,268940,29173,213525,2,4
748,55526,243,269125,269082,29200,213599,2,4
749,55583,285,297773,297738,29293,242190,2,5
750,55635,59,129510,129501,29341,73875,2,1
751,55696,265,297870,297855,29380,242174,2,5
752,55752,238,269423,269385,29424,213671,2,4
753,55834,263,297947,297934,29492,242113,2,5
754,55907,228,269651,269623,29508,213744,2,4
755,55968,260,298090,298080,29547,242122,2,5
756,55996,233,269884,269851,29569,213888,2,4
757,56099,232,269972,269940,29616,213873,2,4
758,56147,233,270055,270022,29668,213908,2,4
759,56219,256,298316,298310,29746,242097,2,5
760,56299,239,270355,270316,29766,214056,2,4
761,56366,237,270503,270466,29849,214137,2,4
762,56465,263,298502,298489,29896,242037,2,5
763,56556,266,298608,298592,29905,242052,2,5
764,56642,223,270895,270872,29925,214253,2,4
765,56681,248,270943,270895,29939,214262,2,4
766,56749,54,132133,132129,29971,75384,2,1
767,56811,260,298748,298738,30059,241937,2,5
768,56924,41,87061,87020,30096,30137,2,0
769,57017,249,271292,271243,30094,214275,2,4
770,57094,43,87254,87211,30117,30160,2,0
771,57170,236,271428,271392,30184,214258,2,4
772,57238,227,271455,271428,30166,214217,2,4
773,57345,253,299006,299003,30209,241661,2,5
774,57429,272,299128,299106,30275,241699,2,5
775,57501,42,87896,87854,30353,30395,2,0
776,57583,267,299248,299231,30363,241665,2,5
777,57656,250,272083,272033,30440,214427,2,4
778,57738,234,272136,272102,30458,214398,2,4
779,57788,245,272231,272186,30508,214443,2,4
780,57851,257,299497,299490,30595,241646,2,5
781,57939,253,299547,299544,30607,241608,2,5
782,58031,55,134987,134982,30665,76956,2,1
783,58142,75,135256,135231,30704,77114,2,1
784,58196,46,88992,88946,30750,30796,2,0
785,58269,248,272924,272876,30823,214655,2,4
786,58348,255,299890,299885,30894,241542,2,5
787,58429,258,299930,299922,30913,241501,2,5
788,58489,51,135966,135965,30914,77477,2,1
789,58572,259,299939,299930,30912,241367,2,5
790,58663,28,89662,89634,30971,30999,2,0
791,58757,205,273341,273336,31005,214584,2,4
792,58806,218,273459,273441,31056,214653,2,4
793,58847,243,273552,273509,31115,214705,2,4
794,58908,58,136873,136865,31154,77965,2,1
795,58979,263,300272,300259,31183,241293,2,5
796,59071,31,90283,90252,31181,31212,2,0
797,59147,271,300427,300406,31236,241280,2,5
798,59226,258,300477,300469,31257,241251,2,5
799,59294,292,300612,300570,31339,241318,2,5
800,59352,272,300684,300662,31337,241332,2,5
801,59399,252,300736,300734,31390,241337,2,5
802,59475,265,300850,300835,31414,241375,2,5
803,59543,249,274625,274576,31496,215082,2,4
804,59613,245,274720,274675,31526,215107,2,4
805,59698,37,91269,91232,31534,31571,2,0
806,59767,231,274801,274770,31552,215034,2,4
807,59807,64,138917,138903,31612,79110,2,1
808,59905,282,301123,301091,31664,241218,2,5
809,59924,238,275053,275015,31695,215129,2,4
810,60015,257,301151,301144,31706,241136,2,5
811,60092,238,275249,275211,31779,215157,2,4
812,60146,43,92011,91968,31822,31865,2,0
813,60212,40,92051,92011,31799,31839,2,0
814,60291,46,92197,92151,31860,31906,2,0
815,60348,261,301406,301395,31896,241058,2,5
816,60404,36,92380,92344,31940,31976,2,0
817,60488,267,301483,301466,31893,240995,2,5
818,60558,45,92526,92481,31923,31968,2,0
819,60626,240,275862,275822,31950,215236,2,4
820,60721,53,140668,140665,32005,79947,2,1
821,60775,242,276016,275974,32024,215241,2,4
822,60841,228,276097,276069,32108,215256,2,4
823,60877,237,276184,276147,32122,215307,2,4
824,60969,257,301813,301806,32180,240844,2,5
825,61085,270,301883,301863,32164,240798,2,5
826,61120,248,276485,276437,32229,215365,2,4
827,61166,271,301930,301909,32283,240764,2,5
828,61242,247,276682,276635,32307,215440,2,4
829,61315,62,142173,142161,32366,80858,2,1
830,61360,237,276819,276782,32421,215459,2,4
831,61467,252,302115,302113,32414,240648,2,5
832,61536,238,277007,276969,32445,215471,2,4
833,61611,249,277106,277057,32461,215495,2,4
834,61690,268,302333,302315,32532,240643,2,5
835,61781,45,94367,94322,32541,32586,2,0
836,61844,264,302347,302333,32525,240503,2,5
837,61908,263,302410,302397,32611,240502,2,5
838,62011,261,302471,302460,32658,240460,2,5
839,62098,243,277605,277562,32671,215507,2,4
840,62160,55,143955,143950,32754,81795,2,1
841,62249,251,302726,302725,32765,240477,2,5
842,62311,56,144311,144305,32853,82000,2,1
843,62388,272,302884,302862,32876,240496,2,5
844,62451,252,302936,302934,32913,240485,2,5
845,62528,256,302992,302986,32936,240464,2,5
846,62614,243,278431,278388,33000,215817,2,4
847,62697,239,278526,278487,33067,215829,2,4
848,62760,268,303160,303142,33104,240400,2,5
849,62863,225,278768,278743,33151,215905,2,4
850,62914,223,278841,278818,33200,215927,2,4
851,62965,266,303354,303338,33249,240389,2,5
852,63005,245,279036,278991,33309,216031,2,4
853,63090,255,303430,303425,33282,240340,2,5
854,63145,228,279214,279186,33327,216069,2,4
855,63214,271,303577,303556,33358,240363,2,5
856,63297,243,279509,279466,33425,216212,2,4
857,63363,238,279547,279509,33459,216184,2,4
858,63444,242,279689,279647,33528,216245,2,4
859,63485,48,97070,97022,33537,33585,2,0
860,63530,226,279815,279789,33586,216285,2,4
861,63606,257,303927,303920,33660,240321,2,5
862,63664,255,304028,304023,33702,240364,2,5
863,63743,263,304100,304087,33757,240357,2,5
864,63826,243,280383,280340,33774,216557,2,4
865,63874,64,148329,148315,33826,84455,2,1
866,63945,247,280580,280533,33867,216635,2,4
867,64001,41,97953,97912,33911,33952,2,0
868,64111,58,148636,148628,33848,84525,2,1
869,64216,43,98152,98109,33893,33936,2,0
870,64311,246,280880,280834,33941,216569,2,4
871,64342,245,280925,280880,34010,216583,2,4
872,64418,249,281024,280975,34034,216606,2,4
873,64529,277,304735,304708,34073,240206,2,5
874,64594,237,281273,281236,34158,216679,2,4
875,64684,263,304798,304785,34168,240114,2,5
876,64743,244,281477,281433,34209,216734,2,4
877,64814,252,304929,304927,34238,240115,2,5
878,64872,250,281727,281677,34278,216855,2,4
879,64958,238,281824,281786,34342,216866,2,4
880,65043,253,305132,305129,34407,240089,2,5
881,65135,241,282124,282083,34418,216989,2,4
882,65162,46,99649,99603,34441,34487,2,0
883,65240,248,282272,282224,34461,217032,2,4
884,65330,47,99883,99836,34506,34553,2,0
885,65397,280,305384,305354,34489,239987,2,5
886,65472,53,151564,151561,34514,86092,2,1
887,65555,256,305518,305512,34581,239963,2,5
888,65643,272,305540,305518,34643,239897,2,5
889,65687,231,282745,282714,34699,217058,2,4
890,65779,278,305645,305617,34757,239866,2,5
891,65840,267,305712,305695,34785,239872,2,5
892,65920,250,283054,283004,34805,217134,2,4
893,66006,250,283104,283054,34869,217098,2,4
894,66086,44,100984,100940,34854,34898,2,0
895,66193,51,153123,153122,34891,86930,2,1
896,66263,256,305957,305951,34971,239694,2,5
897,66347,252,306006,306004,34963,239659,2,5
898,66427,248,283579,283531,35033,217152,2,4
899,66495,233,283612,283579,35065,217117,2,4
900,66573,253,306151,306148,35137,239578,2,5
901,66640,231,283853,283822,35129,217213,2,4
902,66725,274,306185,306161,35136,239460,2,5
903,66808,251,306223,306222,35203,239415,2,5
904,66885,64,154665,154651,35226,87780,2,1
905,66989,260,306362,306352,35272,239373,2,5
906,67095,251,306509,306508,35344,239414,2,5
907,67176,246,284515,284469,35363,217339,2,4
908,67254,248,284663,284615,35435,217409,2,4
909,67317,236,284699,284663,35472,217382,2,4
910,67384,56,155771,155765,35494,88387,2,1
911,67520,249,284898,284849,35525,217378,2,4
912,67590,244,284942,284898,35555,217352,2,4
913,67660,241,285083,285042,35585,217423,2,4
914,67733,278,306911,306883,35662,239178,2,5
915,67804,270,306969,306949,35641,239165,2,5
916,67880,280,307081,307051,35668,239201,2,5
917,67963,269,307150,307131,35685,239187,2,5
918,68055,231,285690,285659,35743,217635,2,4
919,68182,263,307290,307277,35769,239108,2,5
920,68252,242,285882,285840,35796,217630,2,4
921,68305,61,157739,157728,35843,89434,2,1
922,68380,61,157900,157889,35868,89520,2,1
923,68451,258,307568,307560,35898,239117,2,5
924,68499,63,158263,158250,35950,89764,2,1
925,68554,44,104593,104549,35995,36039,2,0
926,68631,260,307788,307778,36012,239157,2,5
927,68723,56,158676,158670,36070,89953,2,1
928,68813,236,286604,286568,36080,217791,2,4
929,68876,245,286749,286704,36153,217873,2,4
930,68940,52,159076,159074,36139,90136,2,1
931,68967,58,159134,159126,36181,90167,2,1
932,68987,248,286947,286899,36211,217960,2,4
933,69066,257,308045,308038,36282,238979,2,5
934,69133,252,308132,308130,36315,238999,2,5
935,69210,45,105593,105548,36338,36383,2,0
936,69270,242,287391,287349,36423,218121,2,4
937,69385,235,287450,287415,36446,218065,2,4
938,69469,43,106024,105981,36512,36555,2,0
939,69561,255,308407,308402,36513,238846,2,5
940,69614,213,287775,287762,36560,218161,2,4
941,69666,235,287810,287775,36608,218144,2,4
942,69699,243,287853,287810,36675,218154,2,4
943,69745,251,308494,308493,36729,238749,2,5
944,69852,248,288051,288003,36772,218199,2,4
945,69916,238,288089,288051,36808,218173,2,4
946,70002,275,308717,308692,36847,238715,2,5
947,70061,276,308793,308767,36888,238732,2,5
948,70123,247,288436,288389,36926,218313,2,4
949,70209,231,288567,288536,36990,218358,2,4
950,70254,255,308986,308981,36995,238732,2,5
951,70342,250,288817,288767,37057,218475,2,4
952,70432,249,288974,288925,37117,218542,2,4
953,70541,262,309223,309211,37120,238682,2,5
954,70620,250,289176,289126,37191,218556,2,4
955,70704,269,309365,309346,37207,238661,2,5
956,70764,234,289410,289376,37242,218646,2,4
957,70816,231,289491,289460,37261,218675,2,4
958,70903,259,309509,309500,37324,238606,2,5
959,70974,258,309567,309559,37353,238593,2,5
960,71010,262,309629,309617,37417,238619,2,5
961,71100,54,164167,164163,37427,93067,2,1
962,71201,265,309738,309723,37441,238537,2,5
963,71292,252,309741,309739,37464,238449,2,5
964,71379,237,290231,290194,37477,218852,2,4
965,71464,232,290313,290281,37525,218849,2,4
966,71531,243,290456,290413,37558,218925,2,4
967,71608,228,290584,290556,37631,218976,2,4
968,71696,237,290671,290634,37643,218975,2,4
969,71789,251,310144,310143,37700,238355,2,5
970,71874,283,310227,310194,37765,238353,2,5
971,71952,253,310279,310276,37787,238327,2,5
972,72037,234,291005,290971,37802,218968,2,4
973,72094,237,291095,291058,37895,219001,2,4
974,72148,40,110129,110089,37941,37981,2,0
975,72204,228,291228,291200,37975,219024,2,4
976,72309,257,310447,310440,37970,238138,2,5
977,72382,221,291399,291378,38007,219017,2,4
978,72462,248,291497,291449,37991,219035,2,4
979,72530,253,310678,310675,38073,238148,2,5
980,72625,221,291818,291797,38128,219193,2,4
981,72693,209,291880,291871,38160,219187,2,4
982,72778,38,111041,111003,38225,38263,2,0
983,72850,245,292085,292040,38241,219235,2,4
984,72888,267,311019,311002,38303,238131,2,5
985,72971,50,111391,111341,38370,38420,2,0
986,73037,268,311117,311099,38394,238080,2,5
987,73102,74,168722,168698,38429,95620,2,1
988,73179,245,292405,292360,38502,219226,2,4
989,73245,237,292442,292405,38536,219197,2,4
990,73306,60,168982,168972,38528,95676,2,1
991,73375,256,311123,311117,38559,237748,2,5
992,73470,56,169134,169128,38569,95664,2,1
993,73535,272,311145,311123,38604,237610,2,5
994,73610,255,311150,311145,38679,237540,2,5
995,73668,274,311174,311150,38671,237506,2,5
996,73710,246,292707,292661,38729,218997,2,4
997,73807,22,112611,112589,38782,38804,2,0
998,73882,225,292740,292715,38779,218858,2,4
999,73968,247,292787,292740,38793,218819,2,4
1000,74061,232,292819,292787,38800,218758,2,4
1001,74142,261,311185,311174,38869,237043,2,5
1002,74220,258,311193,311185,38891,236973,2,5
1003,74331,233,292954,292921,38900,218623,2,4
1004,74400,241,292995,292954,38981,218595,2,4
1005,74455,0,113481,113481,39026,39026,2,0
1006,74510,0,113531,113531,39021,39021,2,0
1007,74546,232,293027,292995,39029,218481,2,4
1008,74647,216,293053,293037,39078,218406,2,4
1009,74687,53,170751,170748,39138,96064,2,1
1010,74737,53,170769,170766,39188,96032,2,1
1011,74803,45,114063,114018,39215,39260,2,0
1012,74864,288,311231,311193,39249,236367,2,5
1013,74943,49,114262,114213,39270,39319,2,0
1014,74949,244,293158,293114,39363,218209,2,4
1015,75027,53,171064,171061,39385,96037,2,1
1016,75117,244,293202,293158,39445,218085,2,4
1017,75165,228,293246,293218,39497,218081,2,4
1018,75240,30,114790,114760,39520,39550,2,0
1019,75318,245,293293,293248,39572,217975,2,4
1020,75389,281,311262,311231,39601,235873,2,5
1021,75454,274,311286,311262,39636,235832,2,5
1022,75548,237,293430,293393,39692,217882,2,4
1023,75588,231,293469,293438,39752,217881,2,4
1024,75682,48,115486,115438,39756,39804,2,0
1025,75761,254,311290,311286,39825,235529,2,5
1026,75822,252,311292,311290,39843,235470,2,5
1027,75856,37,115752,115715,39859,39896,2,0
1028,75933,238,293625,293587,39869,217692,2,4
1029,76043,230,293675,293645,39959,217632,2,4
1030,76098,47,116149,116102,40004,40051,2,0
1031,76164,233,293714,293681,40035,217550,2,4
1032,76217,247,293761,293714,40045,217544,2,4
1033,76294,271,311313,311292,40118,235019,2,5
1034,76349,49,116561,116512,40163,40212,2,0
1035,76461,248,293859,293811,40200,217398,2,4
1036,76562,37,116836,116799,40237,40274,2,0
1037,76658,253,311316,311313,40278,234658,2,5
1038,76736,233,293942,293909,40300,217206,2,4
1039,76819,243,293987,293944,40367,217168,2,4
1040,76893,250,294038,293988,40427,217145,2,4
1041,76953,262,311328,311316,40421,234375,2,5
1042,77028,268,311346,311328,40446,234318,2,5
1043,77103,236,294191,294155,40521,217088,2,4
1044,77154,256,311352,311346,40570,234198,2,5
1045,77203,252,311354,311352,40607,234151,2,5
1046,77290,68,174047,174029,40670,96757,2,1
1047,77357,230,294323,294293,40703,216966,2,4
1048,77398,51,174148,174147,40750,96750,2,1
1049,77455,34,118282,118248,40793,40827,2,0
1050,77557,54,174292,174288,40825,96735,2,1
1051,77627,261,311365,311354,40855,233738,2,5
1052,77718,235,294408,294373,40914,216690,2,4
1053,77820,251,311366,311365,40912,233546,2,5
1054,77854,244,294515,294471,40978,216661,2,4
1055,77892,48,118980,118932,41040,41088,2,0
1056,77976,66,174847,174831,41104,96871,2,1
1057,78056,36,119216,119180,41124,41160,2,0
1058,78117,34,119250,119216,41099,41133,2,0
1059,78174,228,294551,294523,41176,216377,2,4
1060,78259,250,294601,294551,41191,216342,2,4
1061,78325,250,294651,294601,41275,216326,2,4
1062,78381,222,294673,294651,41319,216292,2,4
1063,78452,211,294684,294673,41348,216232,2,4
1064,78497,239,294723,294684,41403,216226,2,4
1065,78583,0,120050,120050,41467,41467,2,0
1066,78653,67,175722,175705,41447,97069,2,1
1067,78727,242,294794,294752,41473,216067,2,4
1068,78814,238,294847,294809,41536,216033,2,4
1069,78885,246,294924,294878,41615,216039,2,4
1070,78951,52,176157,176155,41649,97206,2,1
1071,79046,235,294959,294924,41704,215913,2,4
1072,79138,245,295012,294967,41762,215874,2,4
1073,79214,235,295047,295012,41737,215833,2,4
1074,79281,257,311373,311366,41820,232092,2,5
1075,79367,244,295141,295097,41834,215774,2,4
1076,79445,244,295185,295141,41860,215740,2,4
1077,79503,263,311386,311373,41902,231883,2,5
1078,79587,241,295279,295238,41918,215692,2,4
1079,79664,278,311414,311386,41915,231750,2,5
1080,79722,230,295359,295329,41957,215637,2,4
1081,79802,264,311428,311414,41982,231626,2,5
1082,79881,212,295421,295409,42003,215540,2,4
1083,79960,53,177468,177465,42074,97508,2,1
1084,80035,237,295458,295421,42099,215423,2,4
1085,80102,272,311450,311428,42182,231348,2,5
1086,80164,255,311455,311450,42220,231291,2,5
1087,80218,0,122484,122484,42266,42266,2,0
1088,80307,242,295613,295571,42277,215306,2,4
1089,80415,0,122734,122734,42319,42319,2,0
1090,80448,251,311456,311455,42293,231008,2,5
1091,80538,44,122868,122824,42286,42330,2,0
1092,80610,234,295715,295681,42358,215105,2,4
1093,80702,47,123115,123068,42366,42413,2,0
1094,80790,280,311486,311456,42366,230696,2,5
1095,80880,235,295800,295765,42376,214920,2,4
1096,81006,0,123456,123456,42450,42450,2,0
1097,81058,244,295844,295800,42448,214786,2,4
1098,81170,0,123655,123655,42485,42485,2,0
1099,81239,242,295898,295856,42516,214659,2,4
1100,81303,273,311509,311486,42552,230206,2,5
1101,81401,48,124003,123955,42554,42602,2,0
1102,81496,233,295988,295955,42607,214492,2,4
1103,81601,58,179249,179241,42602,97648,2,1
1104,81699,263,311522,311509,42653,229823,2,5
1105,81766,64,179463,179449,42736,97697,2,1
1106,81841,257,311529,311522,42761,229688,2,5
1107,81939,239,296148,296109,42772,214209,2,4
1108,81998,261,311540,311529,42795,229542,2,5
1109,82069,55,179798,179793,42874,97729,2,1
1110,82139,50,125093,125043,42904,42954,2,0
1111,82242,244,296242,296198,42950,214000,2,4
1112,82309,260,311550,311540,42983,229241,2,5
1113,82409,252,311552,311550,43033,229143,2,5
1114,82444,240,296389,296349,43098,213945,2,4
1115,82504,261,311563,311552,43138,229059,2,5
1116,82572,258,311571,311563,43170,228999,2,5
1117,82667,58,180596,180588,43225,97929,2,1
1118,82710,245,296552,296507,43274,213842,2,4
1119,82763,236,296588,296552,43321,213825,2,4
1120,82836,270,311591,311571,43398,228755,2,5
1121,82896,236,296674,296638,43438,213778,2,4
1122,82948,263,311604,311591,43486,228656,2,5
1123,83037,245,296769,296724,43500,213732,2,4
1124,83121,241,296810,296769,43516,213689,2,4
1125,83202,248,296858,296810,43535,213656,2,4
1126,83254,273,311627,311604,43583,228373,2,5
1127,83288,257,311634,311627,43599,228346,2,5
1128,83343,223,296981,296958,43644,213638,2,4
1129,83432,277,311661,311634,43666,228229,2,5
1130,83501,236,297067,297031,43697,213566,2,4
1131,83544,252,311663,311661,43754,228119,2,5
1132,83608,269,311682,311663,43790,228074,2,5
1133,83685,234,297201,297167,43863,213516,2,4
1134,83764,59,182169,182160,43884,98405,2,1
1135,83846,254,311686,311682,43952,227840,2,5
1136,83931,48,127946,127898,43967,44015,2,0
1137,83955,54,182410,182406,44041,98455,2,1
1138,84031,55,182415,182410,44022,98384,2,1
1139,84096,54,182468,182464,44057,98372,2,1
1140,84157,0,128215,128215,44058,44058,2,0
1141,84221,237,297288,297251,44044,213067,2,4
1142,84281,259,311695,311686,44084,227414,2,5
1143,84338,257,311702,311695,44123,227364,2,5
1144,84390,240,297428,297388,44137,213038,2,4
1145,84413,269,311721,311702,44164,227308,2,5
1146,84508,256,311727,311721,44219,227219,2,5
1147,84580,264,311741,311727,44297,227161,2,5
1148,84682,262,311753,311741,44295,227071,2,5
1149,84761,273,311776,311753,44316,227015,2,5
1150,84822,40,129217,129177,44355,44395,2,0
1151,84901,249,297738,297689,44416,212837,2,4
1152,84963,250,297823,297773,44454,212860,2,4
1153,85027,54,183622,183618,44483,98595,2,1
1154,85114,232,297855,297823,44496,212741,2,4
1155,85183,35,129795,129760,44577,44612,2,0
1156,85264,236,297906,297870,44581,212642,2,4
1157,85340,228,297934,297906,44632,212594,2,4
1158,85405,255,311781,311776,44667,226376,2,5
1159,85489,233,298030,297997,44683,212541,2,4
1160,85527,253,311784,311781,44745,226257,2,5
1161,85598,226,298116,298090,44774,212518,2,4
1162,85713,232,298148,298116,44809,212435,2,4
1163,85807,257,311791,311784,44865,225984,2,5
1164,85877,251,311792,311791,44945,225915,2,5
1165,85934,221,298269,298248,44988,212335,2,4
1166,86015,241,298310,298269,45007,212295,2,4
1167,86089,273,311815,311792,45048,225726,2,5
1168,86177,271,311836,311815,45110,225659,2,5
1169,86236,236,298452,298416,45151,212216,2,4
1170,86292,237,298489,298452,45195,212197,2,4
1171,86425,251,311837,311836,45212,225412,2,5
1172,86461,240,298592,298552,45226,212131,2,4
1173,86563,239,298647,298608,45316,212084,2,4
1174,86660,0,131979,131979,45319,45319,2,0
1175,86730,241,298688,298647,45349,211958,2,4
1176,86817,57,186041,186034,45316,99224,2,1
1177,86899,254,311841,311837,45347,224942,2,5
1178,86962,265,311856,311841,45384,224894,2,5
1179,87003,224,298822,298798,45443,211819,2,4
1180,87101,242,298864,298822,45445,211763,2,4
1181,87185,248,298912,298864,45509,211727,2,4
1182,87295,49,132843,132794,45499,45548,2,0
1183,87354,241,298953,298912,45518,211599,2,4
1184,87459,47,133119,133072,45613,45660,2,0
1185,87580,262,311868,311856,45598,224288,2,5
1186,87641,259,311877,311868,45637,224236,2,5
1187,87736,261,311888,311877,45692,224152,2,5
1188,87799,246,299174,299128,45729,211375,2,4
1189,87875,219,299193,299174,45803,211318,2,4
1190,87929,238,299231,299193,45799,211302,2,4
1191,88002,271,311909,311888,45876,223907,2,5
1192,88067,243,299341,299298,45911,211274,2,4
1193,88181,40,134157,134117,45936,45976,2,0
1194,88254,253,311912,311909,46003,223658,2,5
1195,88349,249,299440,299391,46058,211091,2,4
1196,88450,267,311929,311912,46082,223479,2,5
1197,88523,247,299544,299497,46109,211021,2,4
1198,88626,231,299578,299547,46156,210952,2,4
1199,88721,257,311936,311929,46211,223215,2,5
1200,88773,259,311945,311936,46214,223172,2,5
1201,88854,276,311971,311945,46283,223117,2,5
1202,88894,44,135231,135187,46293,46337,2,0
1203,88955,230,299758,299728,46351,210803,2,4
1204,89012,234,299792,299758,46344,210780,2,4
1205,89067,257,311978,311971,46389,222911,2,5
1206,89160,49,135655,135606,46446,46495,2,0
1207,89281,243,299885,299842,46474,210604,2,4
1208,89365,232,299922,299890,46500,210557,2,4
1209,89465,36,136002,135966,46501,46537,2,0
1210,89573,233,299972,299939,46479,210399,2,4
1211,89669,242,300014,299972,46524,210345,2,4
1212,89755,244,300058,300014,46538,210303,2,4
1213,89821,236,300094,300058,46594,210273,2,4
1214,89903,266,311994,311978,46612,222091,2,5
1215,89993,241,300185,300144,46672,210192,2,4
1216,90108,237,300222,300185,46707,210114,2,4
1217,90186,237,300259,300222,46720,210073,2,4
1218,90247,277,312021,311994,46759,221774,2,5
1219,90267,43,137099,137056,46789,46832,2,0
1220,90335,241,300363,300322,46814,210028,2,4
1221,90409,243,300406,300363,46837,209997,2,4
1222,90473,43,137389,137346,46873,46916,2,0
1223,90524,242,300469,300427,46915,209945,2,4
1224,90595,251,312022,312021,46994,221427,2,5
1225,90635,243,300570,300527,47054,209935,2,4
1226,90701,250,300662,300612,47088,209961,2,4
1227,90780,263,312035,312022,47109,221255,2,5
1228,90860,249,300785,300736,47179,209925,2,4
1229,90909,271,312056,312035,47230,221147,2,5
1230,91002,62,191195,191183,47287,100193,2,1
1231,91085,255,312061,312056,47285,220976,2,5
1232,91147,230,300930,300900,47373,209783,2,4
1233,91230,49,138669,138620,47390,47439,2,0
1234,91325,248,300978,300930,47378,209653,2,4
1235,91429,240,301018,300978,47424,209589,2,4
1236,91500,223,301041,301018,47417,209541,2,4
1237,91591,265,312076,312061,47476,220485,2,5
1238,91682,50,139267,139217,47535,47585,2,0
1239,91767,221,301144,301123,47550,209377,2,4
1240,91858,215,301166,301151,47609,209308,2,4
1241,91958,236,301202,301166,47659,209244,2,4
1242,92004,265,312091,312076,47663,220087,2,5
1243,92076,270,312111,312091,47641,220035,2,5
1244,92157,263,312124,312111,47710,219967,2,5
1245,92259,243,301395,301352,47658,209136,2,4
1246,92311,231,301437,301406,47706,209126,2,4
1247,92387,229,301466,301437,47730,209079,2,4
1248,92457,64,192858,192844,47760,100401,2,1
1249,92519,237,301520,301483,47796,209001,2,4
1250,92594,217,301537,301520,47821,208943,2,4
1251,92711,247,301584,301537,47854,208873,2,4
1252,92812,248,301632,301584,47856,208820,2,4
1253,92898,253,312127,312124,47870,219229,2,5
1254,92975,51,193413,193412,47943,100438,2,1
1255,93032,243,301725,301682,47986,208693,2,4
1256,93109,231,301756,301725,48059,208647,2,4
1257,93194,257,312134,312127,48074,218940,2,5
1258,93246,254,312138,312134,48122,218892,2,5
1259,93325,55,193955,193950,48193,100630,2,1
1260,93412,43,141711,141668,48256,48299,2,0
1261,93485,226,301909,301883,48276,208424,2,4
1262,93565,237,301967,301930,48346,208402,2,4
1263,93619,246,302013,301967,48392,208394,2,4
1264,93685,55,194436,194431,48426,100751,2,1
1265,93784,261,312149,312138,48439,218365,2,5
1266,93878,265,312164,312149,48445,218286,2,5
1267,93998,253,312167,312164,48525,218169,2,5
1268,94079,266,312183,312167,48544,218104,2,5
1269,94163,255,312188,312183,48560,218025,2,5
1270,94255,251,312189,312188,48618,217934,2,5
1271,94355,41,143064,143023,48668,48709,2,0
1272,94502,264,312203,312189,48662,217701,2,5
1273,94587,46,143360,143314,48727,48773,2,0
1274,94682,257,312210,312203,48768,217528,2,5
1275,94765,252,312212,312210,48785,217447,2,5
1276,94822,240,302561,302521,48878,207739,2,4
1277,94867,223,302584,302561,48883,207717,2,4
1278,94938,267,312229,312212,48912,217291,2,5
1279,94962,244,302678,302634,48938,207716,2,4
1280,95048,247,302725,302678,48957,207677,2,4
1281,95112,253,312232,312229,48993,217120,2,5
1282,95209,236,302812,302776,49046,207603,2,4
1283,95241,256,312238,312232,49070,216997,2,5
1284,95328,254,312242,312238,49133,216914,2,5
1285,95408,73,196621,196598,49153,101213,2,1
1286,95475,265,312257,312242,49236,216782,2,5
1287,95576,52,196844,196842,49285,101268,2,1
1288,95643,256,312263,312257,49318,216620,2,5
1289,95711,282,312295,312263,49350,216584,2,5
1290,95752,61,197105,197094,49409,101353,2,1
1291,95864,267,312312,312295,49447,216448,2,5
1292,95939,248,303208,303160,49522,207269,2,4
1293,96004,46,145607,145561,49557,49603,2,0
1294,96035,237,303245,303208,49622,207210,2,4
1295,96119,243,303288,303245,49638,207169,2,4
1296,96206,253,312315,312312,49651,216109,2,5
1297,96311,235,303389,303354,49696,207078,2,4
1298,96383,236,303425,303389,49774,207042,2,4
1299,96451,250,303480,303430,49806,207029,2,4
1300,96518,37,146394,146357,49839,49876,2,0
1301,96583,252,312317,312315,49911,215734,2,5
1302,96620,226,303556,303530,49924,206936,2,4
1303,96692,230,303607,303577,50002,206915,2,4
1304,96766,242,303649,303607,50028,206883,2,4
1305,96878,242,303691,303649,50087,206813,2,4
1306,96938,260,312327,312317,50127,215389,2,5
1307,97023,231,303772,303741,50192,206749,2,4
1308,97124,251,312328,312327,50141,215204,2,5
1309,97184,248,303870,303822,50181,206686,2,4
1310,97268,252,312330,312328,50247,215062,2,5
1311,97321,250,303977,303927,50294,206656,2,4
1312,97356,246,304023,303977,50309,206667,2,4
1313,97473,239,304067,304028,50392,206594,2,4
1314,97504,220,304087,304067,50411,206583,2,4
1315,97600,249,304149,304100,50415,206549,2,4
1316,97685,245,304194,304149,50480,206509,2,4
1317,97749,241,304235,304194,50516,206486,2,4
1318,97827,255,312335,312330,50551,214508,2,5
1319,97939,252,312337,312335,50589,214398,2,5
1320,97990,252,312339,312337,50588,214349,2,5
1321,98053,245,304430,304385,50583,206377,2,4
1322,98176,249,304479,304430,50574,206303,2,4
1323,98266,281,312370,312339,50634,214104,2,5
1324,98347,37,149037,149000,50653,50690,2,0
1325,98407,249,304578,304529,50718,206171,2,4
1326,98504,241,304619,304578,50771,206115,2,4
1327,98566,239,304658,304619,50809,206092,2,4
1328,98618,252,312372,312370,50857,213754,2,5
1329,98690,51,200963,200962,50885,102273,2,1
1330,98747,46,149721,149675,50928,50974,2,0
1331,98829,251,312373,312372,50943,213544,2,5
1332,98924,255,312378,312373,50998,213454,2,5
1333,99028,229,304877,304848,51044,205849,2,4
1334,99088,255,312383,312378,51039,213295,2,5
1335,99135,263,312396,312383,51092,213261,2,5
1336,99213,252,312398,312396,51114,213185,2,5
1337,99295,35,150462,150427,51132,51167,2,0
1338,99372,261,312409,312398,51190,213037,2,5
1339,99452,276,312435,312409,51260,212983,2,5
1340,99503,235,305167,305132,51309,205664,2,4
1341,99583,258,312443,312435,51329,212860,2,5
1342,99665,258,312451,312443,51347,212786,2,5
1343,99734,268,312469,312451,51378,212735,2,5
1344,99804,49,151311,151262,51458,51507,2,0
1345,99848,237,305354,305317,51463,205506,2,4
1346,99948,266,312485,312469,51463,212537,2,5
1347,100009,235,305469,305434,51502,205460,2,4
1348,100120,243,305512,305469,51494,205392,2,4
1349,100174,49,151763,151714,51540,51589,2,0
1350,100269,33,151896,151863,51594,51627,2,0
1351,100355,261,312496,312485,51641,212141,2,5
1352,100449,227,305617,305590,51697,205168,2,4
1353,100553,64,203294,203280,51743,102741,2,1
1354,100636,263,312509,312496,51760,211873,2,5
1355,100704,239,305751,305712,51792,205047,2,4
1356,100773,44,152640,152596,51823,51867,2,0
1357,100869,48,152788,152740,51871,51919,2,0
1358,100935,264,312523,312509,51937,211588,2,5
1359,101020,267,312540,312523,51902,211520,2,5
1360,101121,269,312559,312540,51951,211438,2,5
1361,101194,259,312568,312559,51979,211374,2,5
1362,101300,247,306004,305957,52023,204704,2,4
1363,101414,53,204227,204224,52059,102813,2,1
1364,101485,237,306043,306006,52088,204558,2,4
1365,101563,28,153751,153723,52160,52188,2,0
1366,101629,243,306086,306043,52172,204457,2,4
1367,101686,249,306135,306086,52215,204449,2,4
1368,101757,213,306148,306135,52244,204391,2,4
1369,101841,210,306161,306151,52310,204320,2,4
1370,101936,237,306222,306185,52315,204286,2,4
1371,102039,51,205020,205019,52362,102981,2,1
1372,102083,229,306252,306223,52418,204169,2,4
1373,102154,267,312585,312568,52447,210431,2,5
1374,102255,258,312593,312585,52460,210338,2,5
1375,102352,248,306410,306362,52513,204058,2,4
1376,102418,248,306458,306410,52547,204040,2,4
1377,102485,277,312620,312593,52580,210135,2,5
1378,102584,69,205761,205742,52631,103177,2,1
1379,102616,224,306533,306509,52699,203917,2,4
1380,102688,252,312622,312620,52727,209934,2,5
1381,102746,51,206028,206027,52819,103282,2,1
1382,102844,262,312634,312622,52871,209790,2,5
1383,102932,256,312640,312634,52839,209708,2,5
1384,102995,253,312643,312640,52876,209648,2,5
1385,103042,0,155971,155971,52929,52929,2,0
1386,103141,60,206430,206420,52880,103289,2,1
1387,103215,274,312667,312643,52956,209452,2,5
1388,103268,264,312681,312667,53003,209413,2,5
1389,103331,261,312692,312681,53040,209361,2,5
1390,103408,45,156534,156489,53081,53126,2,0
1391,103458,238,306949,306911,53126,203491,2,4
1392,103499,280,312722,312692,53185,209223,2,5
1393,103562,232,307051,307019,53222,203489,2,4
1394,103617,64,207164,207150,53267,103547,2,1
1395,103696,271,312743,312722,53283,209047,2,5
1396,103764,231,307181,307150,53365,203417,2,4
1397,103823,300,312793,312743,53406,208970,2,5
1398,103925,246,307277,307231,53453,203352,2,4
1399,104023,249,307339,307290,53505,203316,2,4
1400,104130,245,307384,307339,53498,203254,2,4
1401,104199,241,307425,307384,53540,203226,2,4
1402,104273,243,307468,307425,53566,203195,2,4
1403,104323,253,312796,312793,53577,208473,2,5
1404,104366,242,307560,307518,53634,203194,2,4
1405,104408,226,307594,307568,53692,203186,2,4
1406,104468,236,307630,307594,53732,203162,2,4
1407,104567,248,307678,307630,53705,203111,2,4
1408,104591,260,312806,312796,53731,208215,2,5
1409,104681,256,312812,312806,53741,208131,2,5
1410,104778,48,158620,158572,53794,53842,2,0
1411,104872,234,307822,307788,53804,202950,2,4
1412,104957,262,312824,312812,53867,207867,2,5
1413,105033,222,307894,307872,53891,202861,2,4
1414,105111,228,307922,307894,53913,202811,2,4
1415,105183,244,307966,307922,53893,202783,2,4
1416,105243,222,307988,307966,53891,202745,2,4
1417,105317,268,312842,312824,53967,207525,2,5
1418,105405,241,308086,308045,54029,202681,2,4
1419,105463,244,308130,308086,54071,202667,2,4
1420,105561,235,308167,308132,54123,202606,2,4
1421,105646,238,308205,308167,54138,202559,2,4
1422,105736,247,308252,308205,54148,202516,2,4
1423,105793,35,160019,159984,54191,54226,2,0
1424,105884,261,312853,312842,54235,206969,2,5
1425,105972,260,312863,312853,54247,206891,2,5
1426,106062,265,312878,312863,54257,206816,2,5
1427,106140,252,312880,312878,54329,206740,2,5
1428,106220,236,308493,308457,54349,202273,2,4
1429,106292,49,160766,160717,54425,54474,2,0
1430,106350,40,160856,160816,54466,54506,2,0
1431,106444,33,160989,160956,54512,54545,2,0
1432,106543,264,312894,312880,54498,206351,2,5
1433,106638,249,308593,308544,54553,201955,2,4
1434,106721,36,161327,161291,54570,54606,2,0
1435,106781,249,308642,308593,54646,201861,2,4
1436,106845,264,312908,312894,54632,206063,2,5
1437,106895,0,161577,161577,54682,54682,2,0
1438,106984,270,312928,312908,54693,205944,2,5
1439,107051,257,312935,312928,54772,205884,2,5
1440,107107,263,312948,312935,54816,205841,2,5
1441,107188,252,312950,312948,54835,205762,2,5
1442,107278,238,308981,308943,54895,201703,2,4
1443,107370,260,312960,312950,54905,205590,2,5
1444,107428,243,309079,309036,54947,201651,2,4
1445,107513,252,312962,312960,55012,205449,2,5
1446,107571,243,309172,309129,55030,201601,2,4
1447,107671,239,309211,309172,55080,201540,2,4
1448,107771,263,312975,312962,55130,205204,2,5
1449,107869,250,309323,309273,55182,201454,2,4
1450,107926,223,309346,309323,55225,201420,2,4
1451,108010,236,309401,309365,55241,201391,2,4
1452,108105,219,309420,309401,55246,201315,2,4
1453,108166,278,313003,312975,55285,204837,2,5
1454,108185,59,213012,213003,55366,104827,2,1
1455,108247,230,309500,309470,55404,201253,2,4
1456,108339,259,313012,313003,55462,204673,2,5
1457,108405,274,313036,313012,55496,204631,2,5
1458,108488,47,164098,164051,55563,55610,2,0
1459,108572,258,313044,313036,55541,204472,2,5
1460,108618,244,309723,309679,55549,201105,2,4
1461,108710,201,309739,309738,55607,201029,2,4
1462,108788,61,213673,213662,55621,104885,2,1
1463,108847,242,309783,309741,55662,200936,2,4
1464,108890,246,309829,309783,55719,200939,2,4
1465,108959,250,309879,309829,55800,200920,2,4
1466,109041,248,309927,309879,55818,200886,2,4
1467,109120,251,313045,313044,55839,203925,2,5
1468,109190,226,310003,309977,55919,200813,2,4
1469,109269,243,310046,310003,55940,200777,2,4
1470,109345,270,313065,313045,56014,203720,2,5
1471,109393,247,310143,310096,56066,200750,2,4
1472,109480,52,214712,214710,56079,105232,2,1
1473,109529,57,214769,214762,56130,105240,2,1
1474,109616,261,313076,313065,56193,203460,2,5
1475,109697,249,310276,310227,56262,200579,2,4
1476,109779,27,166086,166059,56280,56307,2,0
1477,109858,50,166194,166144,56286,56336,2,0
1478,109945,55,215247,215242,56349,105302,2,1
1479,109998,230,310309,310279,56396,200311,2,4
1480,110068,290,313116,313076,56426,203048,2,5
1481,110119,231,310390,310359,56471,200271,2,4
1482,110213,39,166729,166690,56477,56516,2,0
1483,110298,251,313117,313116,56531,202819,2,5
1484,110401,248,310495,310447,56578,200094,2,4
1485,110466,261,313128,313117,56613,202662,2,5
1486,110523,270,313148,313128,56656,202625,2,5
1487,110583,265,313163,313148,56696,202580,2,5
1488,110645,230,310675,310645,56734,200030,2,4
1489,110697,232,310710,310678,56782,200013,2,4
1490,110766,254,313167,313163,56822,202401,2,5
1491,110836,256,313173,313167,56852,202337,2,5
1492,110911,288,313211,313173,56927,202300,2,5
1493,111000,25,167963,167938,56938,56963,2,0
1494,111036,257,313218,313211,56977,202182,2,5
1495,111126,249,310959,310910,56987,199833,2,4
1496,111201,243,311002,310959,57062,199801,2,4
1497,111256,230,311049,311019,57107,199793,2,4
1498,111342,259,313227,313218,57171,201885,2,5
1499,111384,35,168598,168563,57179,57214,2,0
Average Response Time,29064.49
Average Turnaround Time,162803.51
